7 16
|==============|
|f....==.......|
|....|....@....|
|....|...==|...|
|..p.......|.f.|
|.......|.G|...|
|==============|